>pos_control_pLlacO1	GGATGCTAACTAAACACCGCTAGCGCAATGCTGATGTGCTCAGTATCTTGTTATCCGCTCACAATGTCAATTGTTATCCGCTCACATTTATGGCGCGCCCTCGAGTCGGCCAACGCGCGGGTTAATGAATCGGCCAACGCGCGGGCGCTTTCCAGTCGGGAAACCTGTCGTGCCAGCTGCATTAATGAATCGGCCAACGCGCGGGAGACGCTTGGAATTACAGGT
>pos_control_apFAB62	ACCTGTAATTCCAAGCGTCTCCCGCGCGTTGGCCGATTCATTAATGCAGCTGGCACGACAGGTTTCCCGACTGGAAAGCGCCCGCGCGTTGGCCGATTCATTAACCCGCGCGTTGGCCGATTCATTAATGCAGCTGGCACGACAGCTCGAGGGCGCGCCTTGACAATTAATCATCCGGCTCGCATAATTATTTCATTTCAGGCTAGCGGTGTTTAGTTAGCATCC
>pos_control_apFAB63	ACCTGTAATTCCAAGCGTCTCCCGCGCGTTGGCCGATTCATTAATGCAGCTGGCACGACAGGTTTCCCGACTGGAAAGCGCCCGCGCGTTGGCCGATTCATTAACCCGCGCGTTGGCCGATTCATTAATGCAGCTGGCACGACAGCTCGAGGGCGCGCCTTGACAATTAATCATCCGGCTCGTAGATTTAACGTATAAAGCGCTAGCGGTGTTTAGTTAGCATCC
>pos_control_apFAB61	ACCTGTAATTCCAAGCGTCTCCCGCGCGTTGGCCGATTCATTAATGCAGCTGGCACGACAGGTTTCCCGACTGGAAAGCGCCCGCGCGTTGGCCGATTCATTAACCCGCGCGTTGGCCGATTCATTAATGCAGCTGGCACGACAGCTCGAGGGCGCGCCTTGACAATTAATCATCCGGCTCGTATAATAGATTCATTAGAGGCTAGCGGTGTTTAGTTAGCATCC
>pos_control_apFAB66	ACCTGTAATTCCAAGCGTCTCCCGCGCGTTGGCCGATTCATTAATGCAGCTGGCACGACAGGTTTCCCGACTGGAAAGCGCCCGCGCGTTGGCCGATTCATTAACCCGCGCGTTGGCCGATTCATTAATGCAGCTGGCACGACAGCTCGAGGGCGCGCCTTGACATCAGGAAAATTTTTCTGTATAATAGATTCATCTCAAGCTAGCGGTGTTTAGTTAGCATCC
>pos_control_apFAB67	ACCTGTAATTCCAAGCGTCTCCCGCGCGTTGGCCGATTCATTAATGCAGCTGGCACGACAGGTTTCCCGACTGGAAAGCGCCCGCGCGTTGGCCGATTCATTAACCCGCGCGTTGGCCGATTCATTAATGCAGCTGGCACGACAGCTCGAGGGCGCGCCTTGACATCAGGAAAATTTTTCTGCATAATTATTTCATATCACGCTAGCGGTGTTTAGTTAGCATCC
>pos_control_apFAB64	ACCTGTAATTCCAAGCGTCTCCCGCGCGTTGGCCGATTCATTAATGCAGCTGGCACGACAGGTTTCCCGACTGGAAAGCGCCCGCGCGTTGGCCGATTCATTAACCCGCGCGTTGGCCGATTCATTAATGCAGCTGGCACGACAGCTCGAGGGCGCGCCTTGACATCAGGAAAATTTTTCTGATACTTACAGCCATACCTAGCTAGCGGTGTTTAGTTAGCATCC
>pos_control_apFAB65	ACCTGTAATTCCAAGCGTCTCCCGCGCGTTGGCCGATTCATTAATGCAGCTGGCACGACAGGTTTCCCGACTGGAAAGCGCCCGCGCGTTGGCCGATTCATTAACCCGCGCGTTGGCCGATTCATTAATGCAGCTGGCACGACAGCTCGAGGGCGCGCCTTGACATCAGGAAAATTTTTCTGTATAATGTGTGGATTCGTAGCTAGCGGTGTTTAGTTAGCATCC
>pos_control_apFAB68	ACCTGTAATTCCAAGCGTCTCCCGCGCGTTGGCCGATTCATTAATGCAGCTGGCACGACAGGTTTCCCGACTGGAAAGCGCCCGCGCGTTGGCCGATTCATTAACCCGCGCGTTGGCCGATTCATTAATGCAGCTGGCACGACAGCTCGAGGGCGCGCCTTGACATCAGGAAAATTTTTCTGTAGATTTAACGTATAGGTAGCTAGCGGTGTTTAGTTAGCATCC
>pos_control_apFAB69	ACCTGTAATTCCAAGCGTCTCCCGCGCGTTGGCCGATTCATTAATGCAGCTGGCACGACAGGTTTCCCGACTGGAAAGCGCCCGCGCGTTGGCCGATTCATTAACCCGCGCGTTGGCCGATTCATTAATGCAGCTGGCACGACAGCTCGAGGGCGCGCCTTGACATCGCATCTTTTTGTACCATACTTACAGCCATTGTACGCTAGCGGTGTTTAGTTAGCATCC
>pos_control_galP1	ACCTGTAATTCCAAGCGTCTCCCGCGCGTTGGCCGATTCATTAATGCAGCTGGCACGACAGGTTTCCCGACTGGAAAGCGCCCGCGCGTTGGCCGATTCATTAACCCGCGCGTTGGCCGATTCACTCGAGGGCGCGCCTTTATTCCATGTCACACTTTTCGCATCTTTGTTATGCTATGGTTATTTCATACCATAATTCGAGCTAGCGGTGTTTAGTTAGCATCC
>pos_control_apFAB115	ACCTGTAATTCCAAGCGTCTCCCGCGCGTTGGCCGATTCATTAATGCAGCTGGCACGACAGGTTTCCCGACTGGAAAGCGCCCGCGCGTTGGCCGATTCATTAACCCGCGCGTTGGCCGATTCATTAATGCAGCTGGCACGACAGCTCGAGGGCGCGCCTCGACATCAGGAAAATTTTTCTGTATAATGTGTGGATCTACAGCTAGCGGTGTTTAGTTAGCATCC
>pos_control_apFAB114	ACCTGTAATTCCAAGCGTCTCCCGCGCGTTGGCCGATTCATTAATGCAGCTGGCACGACAGGTTTCCCGACTGGAAAGCGCCCGCGCGTTGGCCGATTCATTAACCCGCGCGTTGGCCGATTCATTAATGCAGCTGGCACGACAGCTCGAGGGCGCGCCTCGACATCAGGAAAATTTTTCTGATACTTACAGCCATGCGGAGCTAGCGGTGTTTAGTTAGCATCC
>pos_control_apFAB89	ACCTGTAATTCCAAGCGTCTCCCGCGCGTTGGCCGATTCATTAATGCAGCTGGCACGACAGGTTTCCCGACTGGAAAGCGCCCGCGCGTTGGCCGATTCATTAACCCGCGCGTTGGCCGATTCATTAATGCAGCCTCGAGGGCGCGCCAAAAAATTTATTTGCTTTCAGGAAAATTTTTCTGATACTTACAGCCATATTATGCTAGCGGTGTTTAGTTAGCATCC
>pos_control_J23101	ACCTGTAATTCCAAGCGTCTCCCGCGCGTTGGCCGATTCATTAATGCAGCTGGCACGACAGGTTTCCCGACTGGAAAGCGCCCGCGCGTTGGCCGATTCATTAACCCGCGCGTTGGCCGATTCATTAATGCAGCTGGCACGACAGGTCTCGAGGGCGCGCCTTTACAGCTAGCTCAGTCCTAGGTATTATGCTAGCCAGTTGCTAGCGGTGTTTAGTTAGCATCC
>pos_control_apFAB124	ACCTGTAATTCCAAGCGTCTCCCGCGCGTTGGCCGATTCATTAATGCAGCTGGCACGACAGGTTTCCCGACTGGAAAGCGCCCGCGCGTTGGCCGATTCATTAACCCGCGCGTTGGCCGATTCATTAATGCAGCTGGCACGACAGCTCGAGGGCGCGCCTCGACATTTATCCCTTGCGGCGAATACTTACAGCCATAGCAAGCTAGCGGTGTTTAGTTAGCATCC
>pos_control_apFAB125	ACCTGTAATTCCAAGCGTCTCCCGCGCGTTGGCCGATTCATTAATGCAGCTGGCACGACAGGTTTCCCGACTGGAAAGCGCCCGCGCGTTGGCCGATTCATTAACCCGCGCGTTGGCCGATTCATTAATGCAGCTGGCACGACAGCTCGAGGGCGCGCCTCGACATTTATCCCTTGCGGCGATATAATGTGTGGATAATCCGCTAGCGGTGTTTAGTTAGCATCC
>pos_control_apFAB98	ACCTGTAATTCCAAGCGTCTCCCGCGCGTTGGCCGATTCATTAATGCAGCTGGCACGACAGGTTTCCCGACTGGAAAGCGCCCGCGCGTTGGCCGATTCATTAACCCGCGCGTTGGCCGATTCATTAATGCAGCCTCGAGGGCGCGCCAAAAAATTTATTTGCTTTCGCATCTTTTTGTACCTAGATTTAACGTATCCCGAGCTAGCGGTGTTTAGTTAGCATCC
>pos_control_apFAB97	ACCTGTAATTCCAAGCGTCTCCCGCGCGTTGGCCGATTCATTAATGCAGCTGGCACGACAGGTTTCCCGACTGGAAAGCGCCCGCGCGTTGGCCGATTCATTAACCCGCGCGTTGGCCGATTCATTAATGCAGCCTCGAGGGCGCGCCAAAAAATTTATTTGCTTTCGCATCTTTTTGTACCCATAATTATTTCATCTTCTGCTAGCGGTGTTTAGTTAGCATCC
>pos_control_apFAB96	ACCTGTAATTCCAAGCGTCTCCCGCGCGTTGGCCGATTCATTAATGCAGCTGGCACGACAGGTTTCCCGACTGGAAAGCGCCCGCGCGTTGGCCGATTCATTAACCCGCGCGTTGGCCGATTCATTAATGCAGCCTCGAGGGCGCGCCAAAAAATTTATTTGCTTTCGCATCTTTTTGTACCTATAATAGATTCATTGGCCGCTAGCGGTGTTTAGTTAGCATCC
>pos_control_apFAB95	ACCTGTAATTCCAAGCGTCTCCCGCGCGTTGGCCGATTCATTAATGCAGCTGGCACGACAGGTTTCCCGACTGGAAAGCGCCCGCGCGTTGGCCGATTCATTAACCCGCGCGTTGGCCGATTCATTAATGCAGCCTCGAGGGCGCGCCAAAAAATTTATTTGCTTTCGCATCTTTTTGTACCTATAATGTGTGGATAATAAGCTAGCGGTGTTTAGTTAGCATCC
>pos_control_apFAB94	ACCTGTAATTCCAAGCGTCTCCCGCGCGTTGGCCGATTCATTAATGCAGCTGGCACGACAGGTTTCCCGACTGGAAAGCGCCCGCGCGTTGGCCGATTCATTAACCCGCGCGTTGGCCGATTCATTAATGCAGCCTCGAGGGCGCGCCAAAAAATTTATTTGCTTTCGCATCTTTTTGTACCATACTTACAGCCATTACTGGCTAGCGGTGTTTAGTTAGCATCC
>pos_control_apFAB93	ACCTGTAATTCCAAGCGTCTCCCGCGCGTTGGCCGATTCATTAATGCAGCTGGCACGACAGGTTTCCCGACTGGAAAGCGCCCGCGCGTTGGCCGATTCATTAACCCGCGCGTTGGCCGATTCATTAATGCAGCCTCGAGGGCGCGCCAAAAAATTTATTTGCTTTCAGGAAAATTTTTCTGTAGATTTAACGTATGCCCAGCTAGCGGTGTTTAGTTAGCATCC
>pos_control_apFAB92	ACCTGTAATTCCAAGCGTCTCCCGCGCGTTGGCCGATTCATTAATGCAGCTGGCACGACAGGTTTCCCGACTGGAAAGCGCCCGCGCGTTGGCCGATTCATTAACCCGCGCGTTGGCCGATTCATTAATGCAGCCTCGAGGGCGCGCCAAAAAATTTATTTGCTTTCAGGAAAATTTTTCTGCATAATTATTTCATGGAGCGCTAGCGGTGTTTAGTTAGCATCC
>pos_control_apFAB322	ACCTGTAATTCCAAGCGTCTCCCGCGCGTTGGCCGATTCATTAATGCAGCTGGCACGACAGGTTTCCCGACTGGAAAGCGCCCGCGCGTTGGCCGATTCATTAACCCGCGCGTTGGCCGATTCATTAATGCAGCTGGCACGACAGGCTCGAGGGCGCGCCTTGCGTATTAATCATCCGGCTCGTATAATGTGTGGATGATCGCTAGCGGTGTTTAGTTAGCATCC
>pos_control_apFAB129	ACCTGTAATTCCAAGCGTCTCCCGCGCGTTGGCCGATTCATTAATGCAGCTGGCACGACAGGTTTCCCGACTGGAAAGCGCCCGCGCGTTGGCCGATTCATTAACCCGCGCGTTGGCCGATTCATTAATGCAGCTGCTCGAGGGCGCGCCCACGGTGTTAGACATAAAGTCTAACCTATAGGATACTTACAGCCATGCCGTGCTAGCGGTGTTTAGTTAGCATCC
>pos_control_BBa_J23103	ACCTGTAATTCCAAGCGTCTCCCGCGCGTTGGCCGATTCATTAATGCAGCTGGCACGACAGGTTTCCCGACTGGAAAGCGCCCGCGCGTTGGCCGATTCATTAACCCGCGCGTTGGCCGATTCATTAATGCAGCTGGCACGACAGGTCTCGAGGGCGCGCCCTGATAGCTAGCTCAGTCCTAGGGATTATGCTAGCAGATGGCTAGCGGTGTTTAGTTAGCATCC
>pos_control_BBa_J23105	ACCTGTAATTCCAAGCGTCTCCCGCGCGTTGGCCGATTCATTAATGCAGCTGGCACGACAGGTTTCCCGACTGGAAAGCGCCCGCGCGTTGGCCGATTCATTAACCCGCGCGTTGGCCGATTCATTAATGCAGCTGGCACGACAGGTCTCGAGGGCGCGCCTTTACGGCTAGCTCAGTCCTAGGTACTATGCTAGCAAGGTGCTAGCGGTGTTTAGTTAGCATCC
>pos_control_apFAB78	ACCTGTAATTCCAAGCGTCTCCCGCGCGTTGGCCGATTCATTAATGCAGCTGGCACGACAGGTTTCCCGACTGGAAAGCGCCCGCGCGTTGGCCGATTCATTAACCCGCGCGTTGGCCGATTCATTAATGCAGCTGGCACGACAGCTCGAGGGCGCGCCTTGACATTTATCCCTTGCGGCGATAGATTTAACGTATGACGGGCTAGCGGTGTTTAGTTAGCATCC
>pos_control_apFAB130	ACCTGTAATTCCAAGCGTCTCCCGCGCGTTGGCCGATTCATTAATGCAGCTGGCACGACAGGTTTCCCGACTGGAAAGCGCCCGCGCGTTGGCCGATTCATTAACCCGCGCGTTGGCCGATTCATTAATGCAGCTGCTCGAGGGCGCGCCCACGGTGTTAGACATAAAGTCTAACCTATAGGTATAATGTGTGGATCCGTGGCTAGCGGTGTTTAGTTAGCATCC
>pos_control_apFAB134	ACCTGTAATTCCAAGCGTCTCCCGCGCGTTGGCCGATTCATTAATGCAGCTGGCACGACAGGTTTCCCGACTGGAAAGCGCCCGCGCGTTGGCCGATTCATTAACCCGCGCGTTGGCCGATTCATTAATGCAGCTGGCTCGAGGGCGCGCCCACGGTGTTAGACAATTAATCATCCGGCTCGATACTTACAGCCATGATTCGCTAGCGGTGTTTAGTTAGCATCC
>pos_control_apFAB339	ACCTGTAATTCCAAGCGTCTCCCGCGCGTTGGCCGATTCATTAATGCAGCTGGCACGACAGGTTTCCCGACTGGAAAGCGCCCGCGCGTTGGCCGATTCATTAACCCGCGCGTTGGCCGATTCATTAATGCAGCTGGCACGACAGGCTCGAGGGCGCGCCTTGACAATTAATCATCCGGCTCGTAATTTATGTGGATAGGAGCTAGCGGTGTTTAGTTAGCATCC
>pos_control_apFAB338	ACCTGTAATTCCAAGCGTCTCCCGCGCGTTGGCCGATTCATTAATGCAGCTGGCACGACAGGTTTCCCGACTGGAAAGCGCCCGCGCGTTGGCCGATTCATTAACCCGCGCGTTGGCCGATTCATTAATGCAGCTGGCACGACAGGCTCGAGGGCGCGCCTTGACAATTAATCATCCGGCTCCTAGGATGTGTGGAGGGACGCTAGCGGTGTTTAGTTAGCATCC
>pos_control_apFAB139	ACCTGTAATTCCAAGCGTCTCCCGCGCGTTGGCCGATTCATTAATGCAGCTGGCACGACAGGTTTCCCGACTGGAAAGCGCCCGCGCGTTGGCCGATTCATTAACCCGCGCGTTGGCCGATTCATTAATGCAGCTGGCTCGAGGGCGCGCCCACGGTGTTAGACATCAGGAAAATTTTTCTGATACTTACAGCCATCGACCGCTAGCGGTGTTTAGTTAGCATCC
>pos_control_apFAB85	ACCTGTAATTCCAAGCGTCTCCCGCGCGTTGGCCGATTCATTAATGCAGCTGGCACGACAGGTTTCCCGACTGGAAAGCGCCCGCGCGTTGGCCGATTCATTAACCCGCGCGTTGGCCGATTCATTAATGCAGCCTCGAGGGCGCGCCAAAAAATTTATTTGCTTATTAATCATCCGGCTCGTATAATGTGTGGATACCGCGCTAGCGGTGTTTAGTTAGCATCC
>pos_control_apFAB87	ACCTGTAATTCCAAGCGTCTCCCGCGCGTTGGCCGATTCATTAATGCAGCTGGCACGACAGGTTTCCCGACTGGAAAGCGCCCGCGCGTTGGCCGATTCATTAACCCGCGCGTTGGCCGATTCATTAATGCAGCCTCGAGGGCGCGCCAAAAAATTTATTTGCTTATTAATCATCCGGCTCGCATAATTATTTCATTGGGGGCTAGCGGTGTTTAGTTAGCATCC
>pos_control_apFAB80	ACCTGTAATTCCAAGCGTCTCCCGCGCGTTGGCCGATTCATTAATGCAGCTGGCACGACAGGTTTCCCGACTGGAAAGCGCCCGCGCGTTGGCCGATTCATTAACCCGCGCGTTGGCCGATTCATTAATGCAGCTCGAGGGCGCGCCAAAAAATTTATTTGCTTTAAAGTCTAACCTATAGGTATAATGTGTGGATACAGAGCTAGCGGTGTTTAGTTAGCATCC
>pos_control_apFAB81	ACCTGTAATTCCAAGCGTCTCCCGCGCGTTGGCCGATTCATTAATGCAGCTGGCACGACAGGTTTCCCGACTGGAAAGCGCCCGCGCGTTGGCCGATTCATTAACCCGCGCGTTGGCCGATTCATTAATGCAGCTCGAGGGCGCGCCAAAAAATTTATTTGCTTTAAAGTCTAACCTATAGGTATAATAGATTCATCTCTTGCTAGCGGTGTTTAGTTAGCATCC
>pos_control_apFAB82	ACCTGTAATTCCAAGCGTCTCCCGCGCGTTGGCCGATTCATTAATGCAGCTGGCACGACAGGTTTCCCGACTGGAAAGCGCCCGCGCGTTGGCCGATTCATTAACCCGCGCGTTGGCCGATTCATTAATGCAGCTCGAGGGCGCGCCAAAAAATTTATTTGCTTTAAAGTCTAACCTATAGGCATAATTATTTCATGGTCCGCTAGCGGTGTTTAGTTAGCATCC
>pos_control_apFAB345	ACCTGTAATTCCAAGCGTCTCCCGCGCGTTGGCCGATTCATTAATGCAGCTGGCACGACAGGTTTCCCGACTGGAAAGCGCCCGCGCGTTGGCCGATTCATTAACCCGCGCGTTGGCCGATTCATTAATGCAGCTGGCACGACAGGCTCGAGGGCGCGCCTTGACAATTAATCATCCGGCTCGTAGAGTATGTGGAGTATCGCTAGCGGTGTTTAGTTAGCATCC
>pos_control_apFAB342	ACCTGTAATTCCAAGCGTCTCCCGCGCGTTGGCCGATTCATTAATGCAGCTGGCACGACAGGTTTCCCGACTGGAAAGCGCCCGCGCGTTGGCCGATTCATTAACCCGCGCGTTGGCCGATTCATTAATGCAGCTGGCACGACAGGCTCGAGGGCGCGCCTTGACAATTAATCATCCGGCTCATAAAATTTGTGGAGGCGAGCTAGCGGTGTTTAGTTAGCATCC
>pos_control_apFAB39	ACCTGTAATTCCAAGCGTCTCCCGCGCGTTGGCCGATTCATTAATGCAGCTGGCACGACAGGTTTCCCGACTGGAAAGCGCCCGCGCGTTGGCCGATTCATTAACCCGCGCGTTGGCCGATTCATTAATGCAGCTCTCGAGGGCGCGCCAAAAAGAGTATTGACTTCAGGAAAATTTTTCTGATACTTACAGCCATTCCAAGCTAGCGGTGTTTAGTTAGCATCC
>pos_control_apFAB38	ACCTGTAATTCCAAGCGTCTCCCGCGCGTTGGCCGATTCATTAATGCAGCTGGCACGACAGGTTTCCCGACTGGAAAGCGCCCGCGCGTTGGCCGATTCATTAACCCGCGCGTTGGCCGATTCATTAATGCAGCTCTCGAGGGCGCGCCAAAAAGAGTATTGACTATTAATCATCCGGCTCGTAGATTTAACGTATCGGTCGCTAGCGGTGTTTAGTTAGCATCC
>pos_control_apFAB31	ACCTGTAATTCCAAGCGTCTCCCGCGCGTTGGCCGATTCATTAATGCAGCTGGCACGACAGGTTTCCCGACTGGAAAGCGCCCGCGCGTTGGCCGATTCATTAACCCGCGCGTTGGCCGATTCATTAATGCAGCCTCGAGGGCGCGCCAAAAAGAGTATTGACTTAAAGTCTAACCTATAGGTATAATAGATTCATAGGGCGCTAGCGGTGTTTAGTTAGCATCC
>pos_control_apFAB30	ACCTGTAATTCCAAGCGTCTCCCGCGCGTTGGCCGATTCATTAATGCAGCTGGCACGACAGGTTTCCCGACTGGAAAGCGCCCGCGCGTTGGCCGATTCATTAACCCGCGCGTTGGCCGATTCATTAATGCAGCCTCGAGGGCGCGCCAAAAAGAGTATTGACTTAAAGTCTAACCTATAGGTATAATGTGTGGATCATTGGCTAGCGGTGTTTAGTTAGCATCC
>pos_control_apFAB33	ACCTGTAATTCCAAGCGTCTCCCGCGCGTTGGCCGATTCATTAATGCAGCTGGCACGACAGGTTTCCCGACTGGAAAGCGCCCGCGCGTTGGCCGATTCATTAACCCGCGCGTTGGCCGATTCATTAATGCAGCCTCGAGGGCGCGCCAAAAAGAGTATTGACTTAAAGTCTAACCTATAGGTAGATTTAACGTATCTGATGCTAGCGGTGTTTAGTTAGCATCC
>pos_control_apFAB32	ACCTGTAATTCCAAGCGTCTCCCGCGCGTTGGCCGATTCATTAATGCAGCTGGCACGACAGGTTTCCCGACTGGAAAGCGCCCGCGCGTTGGCCGATTCATTAACCCGCGCGTTGGCCGATTCATTAATGCAGCCTCGAGGGCGCGCCAAAAAGAGTATTGACTTAAAGTCTAACCTATAGGCATAATTATTTCATCACTAGCTAGCGGTGTTTAGTTAGCATCC
>pos_control_apFAB36	ACCTGTAATTCCAAGCGTCTCCCGCGCGTTGGCCGATTCATTAATGCAGCTGGCACGACAGGTTTCCCGACTGGAAAGCGCCCGCGCGTTGGCCGATTCATTAACCCGCGCGTTGGCCGATTCATTAATGCAGCTCTCGAGGGCGCGCCAAAAAGAGTATTGACTATTAATCATCCGGCTCGTATAATAGATTCATTGAAGGCTAGCGGTGTTTAGTTAGCATCC
>pos_control_apFAB140	ACCTGTAATTCCAAGCGTCTCCCGCGCGTTGGCCGATTCATTAATGCAGCTGGCACGACAGGTTTCCCGACTGGAAAGCGCCCGCGCGTTGGCCGATTCATTAACCCGCGCGTTGGCCGATTCATTAATGCAGCTGGCTCGAGGGCGCGCCCACGGTGTTAGACATCAGGAAAATTTTTCTGTATAATGTGTGGATGCTTAGCTAGCGGTGTTTAGTTAGCATCC
>pos_control_apFAB149	ACCTGTAATTCCAAGCGTCTCCCGCGCGTTGGCCGATTCATTAATGCAGCTGGCACGACAGGTTTCCCGACTGGAAAGCGCCCGCGCGTTGGCCGATTCATTAACCCGCGCGTTGGCCGATTCATTAATGCAGCTGGCTCGAGGGCGCGCCCACGGTGTTAGACATTTATCCCTTGCGGCGAATACTTACAGCCATGTGAAGCTAGCGGTGTTTAGTTAGCATCC
>pos_control_apFAB321	ACCTGTAATTCCAAGCGTCTCCCGCGCGTTGGCCGATTCATTAATGCAGCTGGCACGACAGGTTTCCCGACTGGAAAGCGCCCGCGCGTTGGCCGATTCATTAACCCGCGCGTTGGCCGATTCATTAATGCAGCTGGCACGACAGGCTCGAGGGCGCGCCTTGACAATTAATCATCCGGCTCGTAACTTATGTGGACTCGGGCTAGCGGTGTTTAGTTAGCATCC
>pos_control_apFAB302	ACCTGTAATTCCAAGCGTCTCCCGCGCGTTGGCCGATTCATTAATGCAGCTGGCACGACAGGTTTCCCGACTGGAAAGCGCCCGCGCGTTGGCCGATTCATTAACCCGCGCGTTGGCCGATTCATTAATGCAGCTGGCACGACAGGCTCGAGGGCGCGCCTTCCCTTTTAATCATCCGGCTCGTATAATGTGTGGAGACTTGCTAGCGGTGTTTAGTTAGCATCC
>pos_control_apFAB300	ACCTGTAATTCCAAGCGTCTCCCGCGCGTTGGCCGATTCATTAATGCAGCTGGCACGACAGGTTTCCCGACTGGAAAGCGCCCGCGCGTTGGCCGATTCATTAACCCGCGCGTTGGCCGATTCATTAATGCAGCTGGCACGACAGGCTCGAGGGCGCGCCTTGCCGCTTAATCATCCGGCTCGTATAATGTGTGGATCTTCGCTAGCGGTGTTTAGTTAGCATCC
>pos_control_apFAB323	ACCTGTAATTCCAAGCGTCTCCCGCGCGTTGGCCGATTCATTAATGCAGCTGGCACGACAGGTTTCCCGACTGGAAAGCGCCCGCGCGTTGGCCGATTCATTAACCCGCGCGTTGGCCGATTCATTAATGCAGCTGGCACGACAGGCTCGAGGGCGCGCCTTGTATTTTAATCATCCGGCTCGTATAATGTGTGGAATCCAGCTAGCGGTGTTTAGTTAGCATCC
>pos_control_apFAB306	ACCTGTAATTCCAAGCGTCTCCCGCGCGTTGGCCGATTCATTAATGCAGCTGGCACGACAGGTTTCCCGACTGGAAAGCGCCCGCGCGTTGGCCGATTCATTAACCCGCGCGTTGGCCGATTCATTAATGCAGCTGGCACGACAGGCTCGAGGGCGCGCCTTGACAATTAATCATCCGGCTCGTAGTGTTTGTGGATGTTGGCTAGCGGTGTTTAGTTAGCATCC
>pos_control_apFAB317	ACCTGTAATTCCAAGCGTCTCCCGCGCGTTGGCCGATTCATTAATGCAGCTGGCACGACAGGTTTCCCGACTGGAAAGCGCCCGCGCGTTGGCCGATTCATTAACCCGCGCGTTGGCCGATTCATTAATGCAGCTGGCACGACAGGCTCGAGGGCGCGCCTTGATATTTAATCATCCGGCTCGTATAATGTGTGGAGCACCGCTAGCGGTGTTTAGTTAGCATCC
>pos_control_apFAB311	ACCTGTAATTCCAAGCGTCTCCCGCGCGTTGGCCGATTCATTAATGCAGCTGGCACGACAGGTTTCCCGACTGGAAAGCGCCCGCGCGTTGGCCGATTCATTAACCCGCGCGTTGGCCGATTCATTAATGCAGCTGGCACGACAGGCTCGAGGGCGCGCCTTGACAATTAATCATCCGGCTCGTAGGTTGTGTGGACGGCTGCTAGCGGTGTTTAGTTAGCATCC
>pos_control_apFAB312	ACCTGTAATTCCAAGCGTCTCCCGCGCGTTGGCCGATTCATTAATGCAGCTGGCACGACAGGTTTCCCGACTGGAAAGCGCCCGCGCGTTGGCCGATTCATTAACCCGCGCGTTGGCCGATTCATTAATGCAGCTGGCACGACAGGCTCGAGGGCGCGCCTTGACAATTAATCATCCGGCTCTTAGTGTTTGTGGAGCATTGCTAGCGGTGTTTAGTTAGCATCC
>pos_control_apFAB318	ACCTGTAATTCCAAGCGTCTCCCGCGCGTTGGCCGATTCATTAATGCAGCTGGCACGACAGGTTTCCCGACTGGAAAGCGCCCGCGCGTTGGCCGATTCATTAACCCGCGCGTTGGCCGATTCATTAATGCAGCTGGCACGACAGGCTCGAGGGCGCGCCTTGACTATTAATCATCCGGCTCGTATAATGTGTGGATACACGCTAGCGGTGTTTAGTTAGCATCC
>pos_control_apFAB29	ACCTGTAATTCCAAGCGTCTCCCGCGCGTTGGCCGATTCATTAATGCAGCTGGCACGACAGGTTTCCCGACTGGAAAGCGCCCGCGCGTTGGCCGATTCATTAACCCGCGCGTTGGCCGATTCATTAATGCAGCCTCGAGGGCGCGCCAAAAAGAGTATTGACTTAAAGTCTAACCTATAGGATACTTACAGCCATCCAGCGCTAGCGGTGTTTAGTTAGCATCC
>pos_control_apFAB150	ACCTGTAATTCCAAGCGTCTCCCGCGCGTTGGCCGATTCATTAATGCAGCTGGCACGACAGGTTTCCCGACTGGAAAGCGCCCGCGCGTTGGCCGATTCATTAACCCGCGCGTTGGCCGATTCATTAATGCAGCTGGCTCGAGGGCGCGCCCACGGTGTTAGACATTTATCCCTTGCGGCGATATAATGTGTGGATCCATAGCTAGCGGTGTTTAGTTAGCATCC
>pos_control_apFAB259	ACCTGTAATTCCAAGCGTCTCCCGCGCGTTGGCCGATTCATTAATGCAGCTGGCACGACAGGTTTCCCGACTGGAAAGCGCCCGCGCGTTGGCCGATTCATTAACCCGCGCGTTGGCCGATTCATTAATGCAGCTGGCACGACAGGCTCGAGGGCGCGCCTTCACACTTAATCATCCGGCTCGTATAATGTGTGGACCGCAGCTAGCGGTGTTTAGTTAGCATCC
>pos_control_BBa_J23118	ACCTGTAATTCCAAGCGTCTCCCGCGCGTTGGCCGATTCATTAATGCAGCTGGCACGACAGGTTTCCCGACTGGAAAGCGCCCGCGCGTTGGCCGATTCATTAACCCGCGCGTTGGCCGATTCATTAATGCAGCTGGCACGACAGGTCTCGAGGGCGCGCCTTGACGGCTAGCTCAGTCCTAGGTATTGTGCTAGCCGTCGGCTAGCGGTGTTTAGTTAGCATCC
>pos_control_apFAB58	ACCTGTAATTCCAAGCGTCTCCCGCGCGTTGGCCGATTCATTAATGCAGCTGGCACGACAGGTTTCCCGACTGGAAAGCGCCCGCGCGTTGGCCGATTCATTAACCCGCGCGTTGGCCGATTCATTAATGCAGCTGGCACGACACTCGAGGGCGCGCCTTGACATAAAGTCTAACCTATAGGTAGATTTAACGTATTCTGAGCTAGCGGTGTTTAGTTAGCATCC
>pos_control_apFAB53	ACCTGTAATTCCAAGCGTCTCCCGCGCGTTGGCCGATTCATTAATGCAGCTGGCACGACAGGTTTCCCGACTGGAAAGCGCCCGCGCGTTGGCCGATTCATTAACCCGCGCGTTGGCCGATTCATTAATGCAGCTCTCGAGGGCGCGCCAAAAAGAGTATTGACTTTTATCCCTTGCGGCGATAGATTTAACGTATCGGGAGCTAGCGGTGTTTAGTTAGCATCC
>pos_control_apFAB52	ACCTGTAATTCCAAGCGTCTCCCGCGCGTTGGCCGATTCATTAATGCAGCTGGCACGACAGGTTTCCCGACTGGAAAGCGCCCGCGCGTTGGCCGATTCATTAACCCGCGCGTTGGCCGATTCATTAATGCAGCTCTCGAGGGCGCGCCAAAAAGAGTATTGACTTTTATCCCTTGCGGCGACATAATTATTTCATAGTTCGCTAGCGGTGTTTAGTTAGCATCC
>pos_control_apFAB50	ACCTGTAATTCCAAGCGTCTCCCGCGCGTTGGCCGATTCATTAATGCAGCTGGCACGACAGGTTTCCCGACTGGAAAGCGCCCGCGCGTTGGCCGATTCATTAACCCGCGCGTTGGCCGATTCATTAATGCAGCTCTCGAGGGCGCGCCAAAAAGAGTATTGACTTTTATCCCTTGCGGCGATATAATGTGTGGATTAACCGCTAGCGGTGTTTAGTTAGCATCC
>pos_control_apFAB57	ACCTGTAATTCCAAGCGTCTCCCGCGCGTTGGCCGATTCATTAATGCAGCTGGCACGACAGGTTTCCCGACTGGAAAGCGCCCGCGCGTTGGCCGATTCATTAACCCGCGCGTTGGCCGATTCATTAATGCAGCTGGCACGACACTCGAGGGCGCGCCTTGACATAAAGTCTAACCTATAGGCATAATTATTTCATCCGACGCTAGCGGTGTTTAGTTAGCATCC
>pos_control_apFAB56	ACCTGTAATTCCAAGCGTCTCCCGCGCGTTGGCCGATTCATTAATGCAGCTGGCACGACAGGTTTCCCGACTGGAAAGCGCCCGCGCGTTGGCCGATTCATTAACCCGCGCGTTGGCCGATTCATTAATGCAGCTGGCACGACACTCGAGGGCGCGCCTTGACATAAAGTCTAACCTATAGGTATAATAGATTCATAGTGAGCTAGCGGTGTTTAGTTAGCATCC
>pos_control_apFAB55	ACCTGTAATTCCAAGCGTCTCCCGCGCGTTGGCCGATTCATTAATGCAGCTGGCACGACAGGTTTCCCGACTGGAAAGCGCCCGCGCGTTGGCCGATTCATTAACCCGCGCGTTGGCCGATTCATTAATGCAGCTGGCACGACACTCGAGGGCGCGCCTTGACATAAAGTCTAACCTATAGGTATAATGTGTGGATCTGGCGCTAGCGGTGTTTAGTTAGCATCC
>pos_control_apFAB54	ACCTGTAATTCCAAGCGTCTCCCGCGCGTTGGCCGATTCATTAATGCAGCTGGCACGACAGGTTTCCCGACTGGAAAGCGCCCGCGCGTTGGCCGATTCATTAACCCGCGCGTTGGCCGATTCATTAATGCAGCTGGCACGACACTCGAGGGCGCGCCTTGACATAAAGTCTAACCTATAGGATACTTACAGCCATACAAGGCTAGCGGTGTTTAGTTAGCATCC
>pos_control_lacUV5	ACCTGTAATTCCAAGCGTCTCCCGCGCGTTGGCCGATTCATTAATGCAGCTGGCACGACAGGTTTCCCGACTGGAAAGCGCCCGCGCGTTGGCCGATTCATTAACCCGCGCGTTGGCCGATTCATTAATCTCGAGGGCGCGCCCCCCAGGCTTTACACTTTATGCTTCCGGCTCGTATAATGTGTGGAATTGTGAGTTGGTGCTAGCGGTGTTTAGTTAGCATCC
>pos_control_apFAB48	ACCTGTAATTCCAAGCGTCTCCCGCGCGTTGGCCGATTCATTAATGCAGCTGGCACGACAGGTTTCCCGACTGGAAAGCGCCCGCGCGTTGGCCGATTCATTAACCCGCGCGTTGGCCGATTCATTAATGCAGCTCTCGAGGGCGCGCCAAAAAGAGTATTGACTTCGCATCTTTTTGTACCTAGATTTAACGTATTACCAGCTAGCGGTGTTTAGTTAGCATCC
>pos_control_apFAB49	ACCTGTAATTCCAAGCGTCTCCCGCGCGTTGGCCGATTCATTAATGCAGCTGGCACGACAGGTTTCCCGACTGGAAAGCGCCCGCGCGTTGGCCGATTCATTAACCCGCGCGTTGGCCGATTCATTAATGCAGCTCTCGAGGGCGCGCCAAAAAGAGTATTGACTTTTATCCCTTGCGGCGAATACTTACAGCCATGTAGAGCTAGCGGTGTTTAGTTAGCATCC
>pos_control_BBa_J23116	ACCTGTAATTCCAAGCGTCTCCCGCGCGTTGGCCGATTCATTAATGCAGCTGGCACGACAGGTTTCCCGACTGGAAAGCGCCCGCGCGTTGGCCGATTCATTAACCCGCGCGTTGGCCGATTCATTAATGCAGCTGGCACGACAGGTCTCGAGGGCGCGCCTTGACAGCTAGCTCAGTCCTAGGGACTATGCTAGCAGGATGCTAGCGGTGTTTAGTTAGCATCC
>pos_control_BBa_J23117	ACCTGTAATTCCAAGCGTCTCCCGCGCGTTGGCCGATTCATTAATGCAGCTGGCACGACAGGTTTCCCGACTGGAAAGCGCCCGCGCGTTGGCCGATTCATTAACCCGCGCGTTGGCCGATTCATTAATGCAGCTGGCACGACAGGTCTCGAGGGCGCGCCTTGACAGCTAGCTCAGTCCTAGGGATTGTGCTAGCCAATCGCTAGCGGTGTTTAGTTAGCATCC
>pos_control_BBa_J23114	ACCTGTAATTCCAAGCGTCTCCCGCGCGTTGGCCGATTCATTAATGCAGCTGGCACGACAGGTTTCCCGACTGGAAAGCGCCCGCGCGTTGGCCGATTCATTAACCCGCGCGTTGGCCGATTCATTAATGCAGCTGGCACGACAGGTCTCGAGGGCGCGCCTTTATGGCTAGCTCAGTCCTAGGTACAATGCTAGCCATACGCTAGCGGTGTTTAGTTAGCATCC
>pos_control_BBa_J23115	ACCTGTAATTCCAAGCGTCTCCCGCGCGTTGGCCGATTCATTAATGCAGCTGGCACGACAGGTTTCCCGACTGGAAAGCGCCCGCGCGTTGGCCGATTCATTAACCCGCGCGTTGGCCGATTCATTAATGCAGCTGGCACGACAGGTCTCGAGGGCGCGCCTTTATAGCTAGCTCAGCCCTTGGTACAATGCTAGCGCCTGGCTAGCGGTGTTTAGTTAGCATCC
>pos_control_apFAB40	ACCTGTAATTCCAAGCGTCTCCCGCGCGTTGGCCGATTCATTAATGCAGCTGGCACGACAGGTTTCCCGACTGGAAAGCGCCCGCGCGTTGGCCGATTCATTAACCCGCGCGTTGGCCGATTCATTAATGCAGCTCTCGAGGGCGCGCCAAAAAGAGTATTGACTTCAGGAAAATTTTTCTGTATAATGTGTGGATGTTCAGCTAGCGGTGTTTAGTTAGCATCC
>pos_control_apFAB42	ACCTGTAATTCCAAGCGTCTCCCGCGCGTTGGCCGATTCATTAATGCAGCTGGCACGACAGGTTTCCCGACTGGAAAGCGCCCGCGCGTTGGCCGATTCATTAACCCGCGCGTTGGCCGATTCATTAATGCAGCTCTCGAGGGCGCGCCAAAAAGAGTATTGACTTCAGGAAAATTTTTCTGCATAATTATTTCATAGGCGGCTAGCGGTGTTTAGTTAGCATCC
>pos_control_BBa_J23119	ACCTGTAATTCCAAGCGTCTCCCGCGCGTTGGCCGATTCATTAATGCAGCTGGCACGACAGGTTTCCCGACTGGAAAGCGCCCGCGCGTTGGCCGATTCATTAACCCGCGCGTTGGCCGATTCATTAATGCAGCTGGCACGACAGGTCTCGAGGGCGCGCCTTGACAGCTAGCTCAGTCCTAGGTATAATGCTAGCACGAAGCTAGCGGTGTTTAGTTAGCATCC
>pos_control_apFAB44	ACCTGTAATTCCAAGCGTCTCCCGCGCGTTGGCCGATTCATTAATGCAGCTGGCACGACAGGTTTCCCGACTGGAAAGCGCCCGCGCGTTGGCCGATTCATTAACCCGCGCGTTGGCCGATTCATTAATGCAGCTCTCGAGGGCGCGCCAAAAAGAGTATTGACTTCGCATCTTTTTGTACCATACTTACAGCCATGAAGTGCTAGCGGTGTTTAGTTAGCATCC
>pos_control_apFAB45	ACCTGTAATTCCAAGCGTCTCCCGCGCGTTGGCCGATTCATTAATGCAGCTGGCACGACAGGTTTCCCGACTGGAAAGCGCCCGCGCGTTGGCCGATTCATTAACCCGCGCGTTGGCCGATTCATTAATGCAGCTCTCGAGGGCGCGCCAAAAAGAGTATTGACTTCGCATCTTTTTGTACCTATAATGTGTGGATAGCGGGCTAGCGGTGTTTAGTTAGCATCC
>pos_control_apFAB46	ACCTGTAATTCCAAGCGTCTCCCGCGCGTTGGCCGATTCATTAATGCAGCTGGCACGACAGGTTTCCCGACTGGAAAGCGCCCGCGCGTTGGCCGATTCATTAACCCGCGCGTTGGCCGATTCATTAATGCAGCTCTCGAGGGCGCGCCAAAAAGAGTATTGACTTCGCATCTTTTTGTACCTATAATAGATTCATTGCTAGCTAGCGGTGTTTAGTTAGCATCC
>pos_control_apFAB47	ACCTGTAATTCCAAGCGTCTCCCGCGCGTTGGCCGATTCATTAATGCAGCTGGCACGACAGGTTTCCCGACTGGAAAGCGCCCGCGCGTTGGCCGATTCATTAACCCGCGCGTTGGCCGATTCATTAATGCAGCTCTCGAGGGCGCGCCAAAAAGAGTATTGACTTCGCATCTTTTTGTACCCATAATTATTTCATTCACAGCTAGCGGTGTTTAGTTAGCATCC
>pos_control_pTrc*	ACCTGTAATTCCAAGCGTCTCCCGCGCGTTGGCCGATTCATTAATGCAGCTGGCACGACAGGTTTCCCGACTGGAAAGCGCCCGCGCGTTGGCCGATTCATTAACCCGCGCGTTGGCCGATTCATTAATGCAGCTGGCCTCGAGGGCGCGCCTTGACAATTAATCATCCGGCTCGTATAATGTGTGGAATTGTGAGATGAGGCTAGCGGTGTTTAGTTAGCATCC
>pos_control_pT7A1	ACCTGTAATTCCAAGCGTCTCCCGCGCGTTGGCCGATTCATTAATGCAGCTGGCACGACAGGTTTCCCGACTGGAAAGCGCCCGCGCGTTGGCCGATTCATTAACCCGCGCGTTGGCCGATTCATTCTCGAGGGCGCGCCTCAAAAAGAGTATTGACTTAAAGTCTAACCTATAGGATACTTACAGCCATCGAGAGCTGCGGCTAGCGGTGTTTAGTTAGCATCC
>pos_control_apFAB277	ACCTGTAATTCCAAGCGTCTCCCGCGCGTTGGCCGATTCATTAATGCAGCTGGCACGACAGGTTTCCCGACTGGAAAGCGCCCGCGCGTTGGCCGATTCATTAACCCGCGCGTTGGCCGATTCATTAATGCAGCTGGCACGACAGGCTCGAGGGCGCGCCTTCCCTATTAATCATCCGGCTCGTATAATGTGTGGAATTTAGCTAGCGGTGTTTAGTTAGCATCC
>pos_control_BBa_J23100	ACCTGTAATTCCAAGCGTCTCCCGCGCGTTGGCCGATTCATTAATGCAGCTGGCACGACAGGTTTCCCGACTGGAAAGCGCCCGCGCGTTGGCCGATTCATTAACCCGCGCGTTGGCCGATTCATTAATGCAGCTGGCACGACAGGTCTCGAGGGCGCGCCTTGACGGCTAGCTCAGTCCTAGGTACAGTGCTAGCTTAATGCTAGCGGTGTTTAGTTAGCATCC
>pos_control_Nopromoter	ACCTGTAATTCCAAGCGTCTCCCGCGCGTTGGCCGATTCATTAATGCAGCTGGCACGACAGGTTTCCCGACTGGAAAGCGCCCGCGCGTTGGCCGATTCATTAACCCGCGCGTTGGCCGATTCATTAATGCAGCTGGCACGACAGGTTTCCCGACTGGAAAGCGTGCAGCCTCGAGGGCGCGCCATTAATCATCCGGAATGGCTAGCGGTGTTTAGTTAGCATCC
>pos_control_BBa_J23102	ACCTGTAATTCCAAGCGTCTCCCGCGCGTTGGCCGATTCATTAATGCAGCTGGCACGACAGGTTTCCCGACTGGAAAGCGCCCGCGCGTTGGCCGATTCATTAACCCGCGCGTTGGCCGATTCATTAATGCAGCTGGCACGACAGGTCTCGAGGGCGCGCCTTGACAGCTAGCTCAGTCCTAGGTACTGTGCTAGCAACCTGCTAGCGGTGTTTAGTTAGCATCC
>pos_control_apFAB79	ACCTGTAATTCCAAGCGTCTCCCGCGCGTTGGCCGATTCATTAATGCAGCTGGCACGACAGGTTTCCCGACTGGAAAGCGCCCGCGCGTTGGCCGATTCATTAACCCGCGCGTTGGCCGATTCATTAATGCAGCTCGAGGGCGCGCCAAAAAATTTATTTGCTTTAAAGTCTAACCTATAGGATACTTACAGCCATAGTCTGCTAGCGGTGTTTAGTTAGCATCC
>pos_control_BBa_J23104	ACCTGTAATTCCAAGCGTCTCCCGCGCGTTGGCCGATTCATTAATGCAGCTGGCACGACAGGTTTCCCGACTGGAAAGCGCCCGCGCGTTGGCCGATTCATTAACCCGCGCGTTGGCCGATTCATTAATGCAGCTGGCACGACAGGTCTCGAGGGCGCGCCTTGACAGCTAGCTCAGTCCTAGGTATTGTGCTAGCTTACGGCTAGCGGTGTTTAGTTAGCATCC
>pos_control_BBa_J23107	ACCTGTAATTCCAAGCGTCTCCCGCGCGTTGGCCGATTCATTAATGCAGCTGGCACGACAGGTTTCCCGACTGGAAAGCGCCCGCGCGTTGGCCGATTCATTAACCCGCGCGTTGGCCGATTCATTAATGCAGCTGGCACGACAGGTCTCGAGGGCGCGCCTTTACGGCTAGCTCAGCCCTAGGTATTATGCTAGCATGGAGCTAGCGGTGTTTAGTTAGCATCC
>pos_control_BBa_J23106	ACCTGTAATTCCAAGCGTCTCCCGCGCGTTGGCCGATTCATTAATGCAGCTGGCACGACAGGTTTCCCGACTGGAAAGCGCCCGCGCGTTGGCCGATTCATTAACCCGCGCGTTGGCCGATTCATTAATGCAGCTGGCACGACAGGTCTCGAGGGCGCGCCTTTACGGCTAGCTCAGTCCTAGGTATAGTGCTAGCGATAGGCTAGCGGTGTTTAGTTAGCATCC
>pos_control_apFAB75	ACCTGTAATTCCAAGCGTCTCCCGCGCGTTGGCCGATTCATTAATGCAGCTGGCACGACAGGTTTCCCGACTGGAAAGCGCCCGCGCGTTGGCCGATTCATTAACCCGCGCGTTGGCCGATTCATTAATGCAGCTGGCACGACAGCTCGAGGGCGCGCCTTGACATTTATCCCTTGCGGCGATATAATGTGTGGATAAGTGGCTAGCGGTGTTTAGTTAGCATCC
>pos_control_BBa_J23108	ACCTGTAATTCCAAGCGTCTCCCGCGCGTTGGCCGATTCATTAATGCAGCTGGCACGACAGGTTTCCCGACTGGAAAGCGCCCGCGCGTTGGCCGATTCATTAACCCGCGCGTTGGCCGATTCATTAATGCAGCTGGCACGACAGGTCTCGAGGGCGCGCCCTGACAGCTAGCTCAGTCCTAGGTATAATGCTAGCCACCGGCTAGCGGTGTTTAGTTAGCATCC
>pos_control_apFAB77	ACCTGTAATTCCAAGCGTCTCCCGCGCGTTGGCCGATTCATTAATGCAGCTGGCACGACAGGTTTCCCGACTGGAAAGCGCCCGCGCGTTGGCCGATTCATTAACCCGCGCGTTGGCCGATTCATTAATGCAGCTGGCACGACAGCTCGAGGGCGCGCCTTGACATTTATCCCTTGCGGCGACATAATTATTTCATTTTGGGCTAGCGGTGTTTAGTTAGCATCC
>pos_control_apFAB76	ACCTGTAATTCCAAGCGTCTCCCGCGCGTTGGCCGATTCATTAATGCAGCTGGCACGACAGGTTTCCCGACTGGAAAGCGCCCGCGCGTTGGCCGATTCATTAACCCGCGCGTTGGCCGATTCATTAATGCAGCTGGCACGACAGCTCGAGGGCGCGCCTTGACATTTATCCCTTGCGGCGATATAATAGATTCATTCCGGGCTAGCGGTGTTTAGTTAGCATCC
>pos_control_apFAB71	ACCTGTAATTCCAAGCGTCTCCCGCGCGTTGGCCGATTCATTAATGCAGCTGGCACGACAGGTTTCCCGACTGGAAAGCGCCCGCGCGTTGGCCGATTCATTAACCCGCGCGTTGGCCGATTCATTAATGCAGCTGGCACGACAGCTCGAGGGCGCGCCTTGACATCGCATCTTTTTGTACCTATAATAGATTCATGATGAGCTAGCGGTGTTTAGTTAGCATCC
>pos_control_apFAB70	ACCTGTAATTCCAAGCGTCTCCCGCGCGTTGGCCGATTCATTAATGCAGCTGGCACGACAGGTTTCCCGACTGGAAAGCGCCCGCGCGTTGGCCGATTCATTAACCCGCGCGTTGGCCGATTCATTAATGCAGCTGGCACGACAGCTCGAGGGCGCGCCTTGACATCGCATCTTTTTGTACCTATAATGTGTGGATAGAGTGCTAGCGGTGTTTAGTTAGCATCC
>pos_control_apFAB73	ACCTGTAATTCCAAGCGTCTCCCGCGCGTTGGCCGATTCATTAATGCAGCTGGCACGACAGGTTTCCCGACTGGAAAGCGCCCGCGCGTTGGCCGATTCATTAACCCGCGCGTTGGCCGATTCATTAATGCAGCTGGCACGACAGCTCGAGGGCGCGCCTTGACATCGCATCTTTTTGTACCTAGATTTAACGTATTCGGCGCTAGCGGTGTTTAGTTAGCATCC
>pos_control_apFAB341	ACCTGTAATTCCAAGCGTCTCCCGCGCGTTGGCCGATTCATTAATGCAGCTGGCACGACAGGTTTCCCGACTGGAAAGCGCCCGCGCGTTGGCCGATTCATTAACCCGCGCGTTGGCCGATTCATTAATGCAGCTGGCACGACAGGCTCGAGGGCGCGCCTTGACAATTAATCATCCGGCTCGTAATATGTGTGGATGGTTGCTAGCGGTGTTTAGTTAGCATCC
>pos_control_apFAB346	ACCTGTAATTCCAAGCGTCTCCCGCGCGTTGGCCGATTCATTAATGCAGCTGGCACGACAGGTTTCCCGACTGGAAAGCGCCCGCGCGTTGGCCGATTCATTAACCCGCGCGTTGGCCGATTCATTAATGCAGCTGGCACGACAGGCTCGAGGGCGCGCCTTGACAATTAATCATCCGGCTCGTAATGTTTGTGGATAGCTGCTAGCGGTGTTTAGTTAGCATCC
>pos_control_apFAB109	ACCTGTAATTCCAAGCGTCTCCCGCGCGTTGGCCGATTCATTAATGCAGCTGGCACGACAGGTTTCCCGACTGGAAAGCGCCCGCGCGTTGGCCGATTCATTAACCCGCGCGTTGGCCGATTCATTAATGCAGCTGGCACGACAGCTCGAGGGCGCGCCTCGACAATTAATCATCCGGCTCGATACTTACAGCCATCGATTGCTAGCGGTGTTTAGTTAGCATCC
>pos_control_apFAB100	ACCTGTAATTCCAAGCGTCTCCCGCGCGTTGGCCGATTCATTAATGCAGCTGGCACGACAGGTTTCCCGACTGGAAAGCGCCCGCGCGTTGGCCGATTCATTAACCCGCGCGTTGGCCGATTCATTAATGCAGCCTCGAGGGCGCGCCAAAAAATTTATTTGCTTTTTATCCCTTGCGGCGATATAATGTGTGGATAGAACGCTAGCGGTGTTTAGTTAGCATCC
>pos_control_apFAB101	ACCTGTAATTCCAAGCGTCTCCCGCGCGTTGGCCGATTCATTAATGCAGCTGGCACGACAGGTTTCCCGACTGGAAAGCGCCCGCGCGTTGGCCGATTCATTAACCCGCGCGTTGGCCGATTCATTAATGCAGCCTCGAGGGCGCGCCAAAAAATTTATTTGCTTTTTATCCCTTGCGGCGATATAATAGATTCATCTTAGGCTAGCGGTGTTTAGTTAGCATCC
>pos_control_apFAB103	ACCTGTAATTCCAAGCGTCTCCCGCGCGTTGGCCGATTCATTAATGCAGCTGGCACGACAGGTTTCCCGACTGGAAAGCGCCCGCGCGTTGGCCGATTCATTAACCCGCGCGTTGGCCGATTCATTAATGCAGCCTCGAGGGCGCGCCAAAAAATTTATTTGCTTTTTATCCCTTGCGGCGATAGATTTAACGTATCACGCGCTAGCGGTGTTTAGTTAGCATCC
>pos_control_apFAB104	ACCTGTAATTCCAAGCGTCTCCCGCGCGTTGGCCGATTCATTAATGCAGCTGGCACGACAGGTTTCCCGACTGGAAAGCGCCCGCGCGTTGGCCGATTCATTAACCCGCGCGTTGGCCGATTCATTAATGCAGCTGGCACGACACTCGAGGGCGCGCCTCGACATAAAGTCTAACCTATAGGATACTTACAGCCATAGCTTGCTAGCGGTGTTTAGTTAGCATCC
>pos_control_PLTETo1	ACCTGTAATTCCAAGCGTCTCCCGCGCGTTGGCCGATTCATTAATGCAGCTGGCACGACAGGTTTCCCGACTGGAAAGCGCCCGCGCGTTGGCCGATTCATTAACCCGCGCGTTGGCCGACTCGAGGGCGCGCCTCCCTATCAGTGATAGAGATTGACATCCCTATCAGTGATAGAGATACTGAGCACATCAGCAGTAATTGCTAGCGGTGTTTAGTTAGCATCC
>pos_control_apFAB347	ACCTGTAATTCCAAGCGTCTCCCGCGCGTTGGCCGATTCATTAATGCAGCTGGCACGACAGGTTTCCCGACTGGAAAGCGCCCGCGCGTTGGCCGATTCATTAACCCGCGCGTTGGCCGATTCATTAATGCAGCTGGCACGACAGGCTCGAGGGCGCGCCTTGACAATTAATCATCCGGCTCTTAATATGTGTGGACGAGGGCTAGCGGTGTTTAGTTAGCATCC
>pos_control_apFAB72	ACCTGTAATTCCAAGCGTCTCCCGCGCGTTGGCCGATTCATTAATGCAGCTGGCACGACAGGTTTCCCGACTGGAAAGCGCCCGCGCGTTGGCCGATTCATTAACCCGCGCGTTGGCCGATTCATTAATGCAGCTGGCACGACAGCTCGAGGGCGCGCCTTGACATCGCATCTTTTTGTACCCATAATTATTTCATGCGTCGCTAGCGGTGTTTAGTTAGCATCC
